ID	                        Представляет уникальный идентификатор записи.
Delivery person ID	        Представляет собой уникальный идентификатор лица, осуществляющего доставку.
Delivery person Age	        Обозначает возраст курьера.
Delivery person Ratings 	Представляет средние оценки, присвоенные курьеру. (от 1 до 5)
Restaurant latitude	        Обозначает широту ресторана.
Restaurant longitude	    Представляет длину ресторана.
Delivery location latitude	Представляет широту места доставки.
Delivery location longitude	Представляет длину места доставки.
Order Date	                Представляет дату размещения заказа.
Time Orderd	                Обозначает время размещения заказа.
Time Order picked	        Обозначает время, когда заказ был забран из ресторана.
Weather conditions	        Представляйте погодные условия (ветрено, солнечно, облачно, штормово, туман, песчаные бури и т. д.)
Road traffic density	    Отображает плотность дорожного движения (пробка, высокая, средняя и низкая).
Vehicle condition	        Отражает состояние автомобиля. (Гладкая, хорошая или средняя)
Type of order	            Обозначает тип заказа (Закуски, Еда, Шведский стол, Напитки и т. д.).
Type of vehicle	            Обозначает тип используемого транспортного средства (мотоцикл, велосипед и т. д.).
multiple deliveries	        Представляет количество заказов, которые будут доставлены за одну попытку.
Festival	                Показывает, праздничный день или нет.
City	                    Представляет город
Time taken	                Показывает время, затраченное курьером на доставку заказа. [ЦЕЛЬ]
